#######################################
#                #                    #
#             #  #  #                 #
#             #  #  #                 #
#             #  #  #                 #
#             #  #  #                 #
#             #  #  #                 #
#             #  #  #                 #
#             #  #  #                 #
#             #  #  #                 #
#             #  #  #                 #
#             #  #  #                 #
#             #     #                 #
#             #     #                 #
#             #     #                 #
#             #     #                 #
#             #     #                 #
#             #     #                 #
#             #     #                 #
#             #     #                 #
#             #     #                 #
#             #     #                 #
#             #     #                 #
#             #     #                 #
#             #     #                 #
#             #     #                 #
#             #     #                 #
#             #     #                 #
#             #     #                 #
#             #     #                 #
#             #     #                 #
#             #     #                 #
#             #     #                 #
#             #     #                 #
#             #     #                 #
#             #     #                 #
#             #     #                 #
#             #     #                 #
#             #     #                 #
#######################################