##################################################
#                #                               #
#             #  #  #                            #
#             #  #  #                            #
#             #  #  #                            #
#             #  #  #                            #
#             #  #  #                            #
#             #  #  #                            #
#             #  #  #                            #
#             #  #  #                            #
#             #  #  #                            #
#             #  #  #                            #
#             #     #                            #
##################################################